구해주세요	VV
가렵다	VV
갇히다	VV
걸렸다	VV
기절하다	VV
깔리다	VV
냄새나다	VV
두드러기생기다	VV
떨어지다	VV
말려주세요	VV
반점생기다	VV
배고프다	VV
알려주세요	VV
연락해주세요	VV
숨을안쉬다	VV
열나다	VV
열어주세요	VV
창백하다	VV
함몰되다	VV
부러지다	VV
피나다	VV
쓰러지다	VV
금가다	VV
토하다	VV
강남구	NN
강동구	NN
강북구	NN
강서구	NN
강풍	NN
경찰차	NN
고속도로	NN
고압전선	NN
고열	NN
공사장	NN
관악구	NN
광진구	NN
교통사고	NN
구급대	NN
구급대원	NN
구급차	NN
구로구	NN
구청	NN
금요일	NN
금천구	NN
끓는물	NN
남자친구	NN
남편	NN
남학생	NN
낯선남자	NN
낯선사람	NN
낯선여자	NN
노원구	NN
놀이터	NN
농약	NN
대문앞	NN
도봉구	NN
독극물	NN
독버섯	NN
독사	NN
동대문구	NN
동작구	NN
뒤통수	NN
뜨거운물	NN
마포구	NN
말벌	NN
맹견	NN
멧돼지	NN
목요일	NN
문틈	NN
밑에	NN
발가락	NN
발목	NN
발작	NN
방망이	NN
비닐하우스	NN
비상약	NN
살충제	NN
살해	NN
서대문구	NN
서울시	NN
서초구	NN
선생님	NN
성동구	NN
성북구	NN
성폭행	NN
소방관	NN
소방차	NN
소화기	NN
소화전	NN
손	NN
손목	NN
송파구	NN
수영장	NN
수요일	NN
술취한 사람	NN
심장마비	NN
아이들	NN
엘리베이터	NN
여자친구	NN
여학생	NN
양천구	NN
윗집	NN
윗집사람	NN
위에	NN
용산구	NN
우리집	NN
운동장	NN
월요일	NN
유치원 버스	NN
은평구	NN
음식물	NN
응급대원	NN
응급처리	NN
이번	NN
이상한사람	NN
이웃집	NN
일요일	NN
임산부	NN
임신한아내	NN
자동차	NN
작은방	NN
제초제	NN
종로구	NN
중구	NN
중랑구	NN
지혈대	NN
진통제	NN
집단폭행	NN
차밖	NN
차안	NN
창문	NN
체온계	NN
토요일	NN
통학버스	NN
해독제	NN
해열제	NN
현관앞	NN
호흡곤란	NN
호흡기	NN
화요일	NN
화장실	NN
생기다	VV
열어	EF
주세요	VV